"filename", "language", "C++", "comment", "blank", "total"
"c:\Academic\Code\Object-Oriented-Raycasting\src\engine\a_star.cpp", "C++", 59, 5, 16, 80
"c:\Academic\Code\Object-Oriented-Raycasting\src\engine\animated_sprite.cpp", "C++", 83, 3, 20, 106
"c:\Academic\Code\Object-Oriented-Raycasting\src\engine\application.cpp", "C++", 105, 1, 27, 133
"c:\Academic\Code\Object-Oriented-Raycasting\src\engine\billboard.cpp", "C++", 5, 0, 2, 7
"c:\Academic\Code\Object-Oriented-Raycasting\src\engine\billboard_manager.cpp", "C++", 41, 6, 14, 61
"c:\Academic\Code\Object-Oriented-Raycasting\src\engine\camera.cpp", "C++", 9, 0, 6, 15
"c:\Academic\Code\Object-Oriented-Raycasting\src\engine\cient.cpp", "C++", 51, 0, 14, 65
"c:\Academic\Code\Object-Oriented-Raycasting\src\engine\constantes.cpp", "C++", 17, 0, 4, 21
"c:\Academic\Code\Object-Oriented-Raycasting\src\engine\effects.cpp", "C++", 62, 1, 14, 77
"c:\Academic\Code\Object-Oriented-Raycasting\src\engine\enemy.cpp", "C++", 45, 9, 14, 68
"c:\Academic\Code\Object-Oriented-Raycasting\src\engine\game_scene.cpp", "C++", 164, 15, 40, 219
"c:\Academic\Code\Object-Oriented-Raycasting\src\engine\gui.cpp", "C++", 129, 11, 22, 162
"c:\Academic\Code\Object-Oriented-Raycasting\src\engine\map.cpp", "C++", 19, 0, 2, 21
"c:\Academic\Code\Object-Oriented-Raycasting\src\engine\minimap.cpp", "C++", 40, 3, 5, 48
"c:\Academic\Code\Object-Oriented-Raycasting\src\engine\player.cpp", "C++", 108, 7, 20, 135
"c:\Academic\Code\Object-Oriented-Raycasting\src\engine\raycaster.cpp", "C++", 223, 47, 64, 334
"c:\Academic\Code\Object-Oriented-Raycasting\src\engine\select_scene.cpp", "C++", 93, 9, 22, 124
"c:\Academic\Code\Object-Oriented-Raycasting\src\engine\server.cpp", "C++", 63, 0, 16, 79
"c:\Academic\Code\Object-Oriented-Raycasting\src\engine\title_scene.cpp", "C++", 91, 9, 20, 120
"c:\Academic\Code\Object-Oriented-Raycasting\src\main.cpp", "C++", 6, 0, 3, 9
"c:\Academic\Code\Object-Oriented-Raycasting\src\unit_tests\vector2D_tests.cpp", "C++", 69, 21, 13, 103
"Total", "-", 1482, 147, 358, 1987